   S         
 . E . . . E 
 - - - = -   
 H . . . .|. 
   -         
 .|. . C ."E 
   -         
 . . . . .|. 
 - - - = -   
 .|E . .". E 
       -     
 . . . . . . 
             