             
 . . . . .|. 
 -           
 . .|. H .|. 
 -   -   -   
 E .|. . . . 
     -       
S.|. .|. . . 
   -   -   - 
 .|A . V . . 
             
 . . . . .|. 
             