           S 
 .|M . . . . 
   -     - - 
 . . .|. . . 
       -     
 . . . .|.|H 
       -     
 . . . .|.|. 
 -       -   
 . .|. . .|. 
             
 . . A .|. . 
             