       S     
 . .|.|. V|. 
 -     -     
 .|. .|. . . 
 -     - -   
 . . H .". C 
 -       -   
 .|. .|. .|. 
             
 .|.|. .|. V 
   -   - -   
 . . . . . . 
             