. .|. . . . .
 - -   - -   
 . . .|. H . 
     - - - - 
 . .|V . V . 
   -	 	 
 . .|. . . . 
 -   - - -   
 . . . . .|. 
		     
 . . .|. . . 
 S			 